Rk,Player,Pos,Age,Tm,G,GS,MP,FG,FGA,FG%,3P,3PA,3P%,2P,2PA,2P%,FT,FTA,FT%,ORB,DRB,TRB,AST,STL,BLK,TOV,PF,PTS
1,Quincy Acy,SF,23,TOR,6,0,61,6,14,.429,2,5,.400,4,9,.444,5,8,.625,5,10,15,4,4,3,2,8,19
2,Steven Adams,C,20,OKC,17,2,287,26,53,.491,0,0,,26,53,.491,22,35,.629,39,46,85,14,6,16,13,45,74
3,Jeff Adrien,PF,27,CHA,13,0,176,15,28,.536,0,0,,15,28,.536,10,17,.588,27,35,62,4,4,11,3,18,40
4,Arron Afflalo,SG,28,ORL,18,18,669,140,287,.488,44,95,.463,96,192,.500,82,96,.854,5,77,82,76,16,1,41,32,406
5,Cole Aldrich,C,25,NYK,6,0,20,2,5,.400,0,0,,2,5,.400,2,2,1.000,3,8,11,3,1,1,2,2,6
6,LaMarcus Aldridge,PF,28,POR,19,19,706,185,389,.476,0,2,.000,185,387,.478,77,98,.786,36,149,185,49,23,17,38,34,447
7,Lavoy Allen,PF,24,PHI,19,2,381,41,89,.461,0,2,.000,41,87,.471,11,19,.579,34,65,99,19,7,11,19,38,93
8,Ray Allen,SG,38,MIA,16,1,405,56,123,.455,25,63,.397,31,60,.517,22,25,.880,7,35,42,37,14,3,22,27,159
9,Tony Allen,SG,32,MEM,16,16,405,68,128,.531,5,19,.263,63,109,.578,26,36,.722,22,31,53,30,37,8,30,35,167
10,Al-Farouq Aminu,SF,23,NOP,17,16,385,45,91,.495,1,5,.200,44,86,.512,13,27,.481,34,75,109,24,23,6,16,25,104
11,Louis Amundson,PF,31,NOP,11,0,98,6,14,.429,0,0,,6,14,.429,3,12,.250,8,14,22,2,3,7,5,28,15
12,Chris Andersen,C,35,MIA,18,0,307,42,68,.618,0,1,.000,42,67,.627,29,40,.725,26,51,77,8,7,19,17,41,113
13,Alan Anderson,SF,31,BRK,19,4,450,53,131,.405,26,71,.366,27,60,.450,18,24,.750,13,41,54,22,17,3,14,40,150
14,James Anderson,SG,24,PHI,19,17,621,74,170,.435,30,89,.337,44,81,.543,19,28,.679,13,57,70,37,20,9,30,34,197
15,Ryan Anderson,PF,25,NOP,9,2,317,70,143,.490,36,68,.529,34,75,.453,23,23,1.000,25,32,57,4,2,3,8,20,199
16,Giannis Antetokounmpo,SF,19,MIL,13,0,210,27,53,.509,6,15,.400,21,38,.553,8,16,.500,9,33,42,12,7,9,13,23,68
17,Carmelo Anthony,PF,29,NYK,17,17,678,158,367,.431,19,66,.288,139,301,.462,105,126,.833,48,120,168,46,18,10,45,55,440
18,Joel Anthony,C,31,MIA,6,0,30,1,4,.250,0,0,,1,4,.250,0,0,,2,3,5,0,0,4,1,4,2
19,Pero Antic,PF,31,ATL,12,0,140,15,44,.341,7,23,.304,8,21,.381,8,11,.727,12,18,30,9,3,4,6,13,45
20,Trevor Ariza,SF,28,WAS,13,13,458,74,155,.477,34,79,.430,40,76,.526,25,37,.676,18,56,74,29,26,2,28,29,207
21,Darrell Arthur,SF,25,DEN,18,0,319,50,103,.485,0,2,.000,50,101,.495,9,10,.900,11,40,51,15,8,11,14,46,109
22,Omer Asik,C,27,HOU,17,8,311,25,53,.472,0,0,,25,53,.472,25,39,.641,28,87,115,7,4,7,20,34,75
23,D.J. Augustin,PG,26,TOR,10,0,82,7,24,.292,1,11,.091,6,13,.462,6,6,1.000,0,4,4,10,1,0,9,7,21
24,Gustavo Ayon,C,28,ATL,8,2,125,15,28,.536,0,0,,15,28,.536,3,4,.750,9,22,31,4,6,4,5,17,33
25,Jeff Ayres,PF,26,SAS,17,0,205,18,40,.450,0,0,,18,40,.450,6,11,.545,11,35,46,14,5,4,16,32,42
26,Jose Barea,PG,29,MIN,19,0,350,63,157,.401,15,53,.283,48,104,.462,9,12,.750,4,34,38,65,7,0,24,22,150
27,Andrea Bargnani,C,28,NYK,17,16,531,102,217,.470,19,56,.339,83,161,.516,38,46,.826,29,60,89,25,6,26,21,48,261
28,Harrison Barnes,SF,21,GSW,15,9,491,80,160,.500,15,32,.469,65,128,.508,28,41,.683,6,43,49,28,15,2,21,33,203
29,Matt Barnes,SF,33,LAC,8,0,160,13,38,.342,4,16,.250,9,22,.409,17,20,.850,8,26,34,13,8,1,10,23,47
30,Will Barton,SG,23,POR,6,0,17,2,5,.400,0,1,.000,2,4,.500,2,2,1.000,0,2,2,2,0,0,1,2,6
31,Brandon Bass,PF,28,BOS,20,18,583,88,189,.466,1,2,.500,87,187,.465,45,51,.882,31,84,115,26,9,25,22,53,222
32,Shane Battier,SF,35,MIA,18,13,386,30,74,.405,18,56,.321,12,18,.667,7,9,.778,5,31,36,11,12,11,1,32,85
33,Nicolas Batum,SF,25,POR,19,19,681,90,195,.462,40,100,.400,50,95,.526,36,45,.800,27,93,120,95,24,10,45,42,256
34,Jerryd Bayless,PG,25,MEM,16,1,303,36,106,.340,9,38,.237,27,68,.397,23,28,.821,5,29,34,28,9,1,13,39,104
35,Aron Baynes,C,27,SAS,10,0,81,6,24,.250,0,0,,6,24,.250,3,4,.750,7,15,22,6,0,0,7,14,15
36,Kent Bazemore,SG,24,GSW,14,0,95,12,32,.375,4,11,.364,8,21,.381,7,14,.500,2,12,14,7,5,2,12,15,35
37,Bradley Beal,SG,20,WAS,13,13,523,101,248,.407,36,82,.439,65,166,.392,30,37,.811,11,43,54,45,12,3,33,30,268
38,Michael Beasley,SF,25,MIA,14,0,247,65,119,.546,9,18,.500,56,101,.554,20,26,.769,12,44,56,9,6,7,16,25,159
39,Marco Belinelli,SF,27,SAS,18,1,384,66,128,.516,27,48,.563,39,80,.488,10,13,.769,4,47,51,38,13,2,18,24,169
40,Anthony Bennett,SF,20,CLE,14,0,159,13,54,.241,4,19,.211,9,35,.257,3,8,.375,12,22,34,4,8,2,10,21,33
41,Patrick Beverley,SG,25,HOU,17,16,537,59,146,.404,29,82,.354,30,64,.469,15,18,.833,26,44,70,41,23,8,21,44,162
42,Andris Biedrins,C,27,UTA,2,0,8,0,0,,0,0,,0,0,,0,0,,0,3,3,0,0,0,1,2,0
43,Chauncey Billups,SG,37,DET,7,7,155,12,36,.333,7,21,.333,5,15,.333,6,8,.750,2,15,17,17,5,1,10,11,37
44,Bismack Biyombo,C,21,CHA,17,9,347,25,38,.658,0,0,,25,38,.658,15,31,.484,28,91,119,1,1,15,10,26,65
45,DeJuan Blair,PF,24,DAL,20,2,425,76,144,.528,0,2,.000,76,142,.535,21,39,.538,61,91,152,28,30,7,27,74,173
46,Steve Blake,PG,33,LAL,18,18,560,63,155,.406,36,84,.429,27,71,.380,18,22,.818,3,55,58,138,16,1,40,29,180
47,Andray Blatche,PF,27,BRK,19,5,422,82,171,.480,4,13,.308,78,158,.494,37,55,.673,35,72,107,22,20,8,37,38,205
48,Eric Bledsoe,PG,24,PHO,13,11,442,84,171,.491,15,46,.326,69,125,.552,62,78,.795,7,48,55,77,21,2,46,28,245
49,Keith Bogans,SG,33,BOS,4,0,28,0,2,.000,0,2,.000,0,0,,0,0,,0,1,1,0,1,0,1,1,0
50,Andrew Bogut,C,29,GSW,18,18,503,62,106,.585,0,0,,62,106,.585,14,33,.424,41,125,166,36,14,31,32,66,138
51,Matt Bonner,PF,33,SAS,11,0,133,13,28,.464,9,21,.429,4,7,.571,0,0,,1,16,17,10,0,2,3,12,35
52,Trevor Booker,PF,26,WAS,10,3,140,18,36,.500,0,1,.000,18,35,.514,0,2,.000,16,21,37,10,7,2,7,15,36
53,Carlos Boozer,PF,32,CHI,17,17,513,113,228,.496,0,0,,113,228,.496,41,51,.804,39,110,149,32,8,9,41,51,267
54,Chris Bosh,C,29,MIA,18,18,513,92,179,.514,14,32,.438,78,147,.531,59,76,.776,18,83,101,13,14,21,26,58,257
55,Avery Bradley,PG,23,BOS,20,20,598,113,259,.436,15,49,.306,98,210,.467,16,22,.727,18,53,71,26,23,4,41,61,257
56,Elton Brand,PF,34,ATL,12,0,126,12,27,.444,0,0,,12,27,.444,7,10,.700,7,31,38,7,2,6,5,11,31
57,Corey Brewer,SF,27,MIN,19,19,654,102,219,.466,23,78,.295,79,141,.560,40,54,.741,17,31,48,28,37,7,35,52,267
58,Ronnie Brewer,SF,28,HOU,7,0,38,1,3,.333,1,3,.333,0,0,,0,2,.000,1,3,4,4,1,0,0,1,3
59,Aaron Brooks,PG,29,HOU,17,0,258,45,101,.446,20,41,.488,25,60,.417,15,17,.882,8,18,26,32,16,2,22,27,125
60,MarShon Brooks,SG,25,BOS,6,0,41,4,15,.267,0,1,.000,4,14,.286,5,6,.833,1,6,7,2,0,0,1,2,13
61,Lorenzo Brown,SG,23,PHI,6,0,29,4,14,.286,1,2,.500,3,12,.250,0,0,,2,3,5,2,2,0,0,1,9
62,Reggie Bullock,SF,22,LAC,16,0,168,17,43,.395,8,27,.296,9,16,.563,4,5,.800,4,19,23,3,1,1,5,8,46
63,Trey Burke,PG,21,UTA,8,6,219,40,101,.396,13,31,.419,27,70,.386,8,9,.889,3,23,26,33,6,0,10,14,101
64,Alec Burks,SG,22,UTA,20,3,533,81,203,.399,10,33,.303,71,170,.418,56,77,.727,17,38,55,51,17,5,35,43,228
65,Caron Butler,SF,33,MIL,12,10,354,55,143,.385,24,65,.369,31,78,.397,24,29,.828,9,58,67,18,12,1,24,25,158
66,Jimmy Butler,SG,24,CHI,9,9,268,30,69,.435,10,26,.385,20,43,.465,31,36,.861,11,32,43,15,16,7,12,9,101
67,Rasual Butler,SG,34,IND,6,0,9,2,3,.667,2,3,.667,0,0,,0,0,,1,1,2,1,0,0,0,1,6
68,Dwight Buycks,PG,24,TOR,10,0,102,10,32,.313,4,14,.286,6,18,.333,7,8,.875,3,12,15,7,3,0,6,9,31
69,Andrew Bynum,C,26,CLE,14,9,251,44,110,.400,0,0,,44,110,.400,23,25,.920,23,39,62,15,2,19,17,18,111
70,Will Bynum,PG,31,DET,10,3,189,29,70,.414,3,9,.333,26,61,.426,22,31,.710,4,12,16,31,11,2,16,25,83
71,Nick Calathes,SG,24,MEM,12,0,138,11,31,.355,0,4,.000,11,27,.407,4,11,.364,1,10,11,28,2,1,17,17,26
72,Jose Calderon,SG,32,DAL,19,19,593,73,167,.437,51,107,.477,22,60,.367,15,16,.938,6,29,35,89,17,1,27,36,212
73,Kentavious Caldwell-Pope,SG,20,DET,17,12,377,49,133,.368,15,52,.288,34,81,.420,16,20,.800,9,28,37,17,17,1,6,30,129
74,DeMarre Carroll,SF,27,ATL,20,20,623,67,154,.435,24,69,.348,43,85,.506,35,44,.795,29,91,120,32,25,5,20,44,193
75,Vince Carter,SG,37,DAL,19,0,464,72,188,.383,30,84,.357,42,104,.404,32,40,.800,16,51,67,45,11,9,21,43,206
76,Michael Carter-Williams,PG,22,PHI,15,15,551,95,233,.408,22,68,.324,73,165,.442,53,79,.671,26,61,87,110,47,11,55,40,265
77,Omri Casspi,PF,25,HOU,19,0,422,65,137,.474,25,58,.431,40,79,.506,24,34,.706,14,68,82,29,18,6,29,36,179
78,Mario Chalmers,PG,27,MIA,17,17,458,49,117,.419,24,60,.400,25,57,.439,26,35,.743,9,34,43,84,28,4,34,49,148
79,Tyson Chandler,C,31,NYK,4,4,107,12,20,.600,0,0,,12,20,.600,5,7,.714,15,21,36,5,4,10,7,10,29
80,Wilson Chandler,SF,26,DEN,12,9,335,46,111,.414,18,53,.340,28,58,.483,16,22,.727,8,39,47,20,15,7,10,31,126
81,Josh Childress,SF,30,NOP,3,0,21,0,0,,0,0,,0,0,,0,0,,0,2,2,1,1,0,1,1,0
82,Dionte Christmas,SF,27,PHO,13,0,95,10,27,.370,4,13,.308,6,14,.429,3,4,.750,4,13,17,1,2,0,3,9,27
83,Earl Clark,PF,26,CLE,15,9,292,35,88,.398,16,36,.444,19,52,.365,5,10,.500,7,45,52,7,11,7,14,27,91
84,Ian Clark,SG,22,UTA,8,0,70,9,26,.346,3,11,.273,6,15,.400,1,3,.333,1,6,7,5,1,1,4,9,22
85,Victor Claver,SF,25,POR,3,0,4,0,0,,0,0,,0,0,,0,0,,0,0,0,0,0,0,1,0,0
86,Norris Cole,PG,25,MIA,19,2,467,55,123,.447,16,35,.457,39,88,.443,8,10,.800,4,52,56,64,16,2,30,33,134
87,Darren Collison,PG,26,LAC,20,1,346,53,123,.431,12,32,.375,41,91,.451,28,34,.824,11,30,41,40,15,6,26,31,146
88,Nick Collison,PF,33,OKC,16,0,275,25,49,.510,1,5,.200,24,44,.545,16,20,.800,16,37,53,14,8,3,14,40,67
89,Mike Conley,PG,26,MEM,18,18,608,126,257,.490,22,69,.319,104,188,.553,53,61,.869,9,27,36,116,27,4,33,40,327
90,Chris Copeland,SF,29,IND,10,0,66,10,26,.385,9,23,.391,1,3,.333,2,2,1.000,0,3,3,4,1,2,1,9,31
91,DeMarcus Cousins,C,23,SAC,15,15,459,127,262,.485,0,4,.000,127,258,.492,72,103,.699,35,116,151,39,24,18,42,65,326
92,Allen Crabbe,SG,21,POR,5,0,10,1,2,.500,0,0,,1,2,.500,2,3,.667,0,1,1,1,0,0,0,1,4
93,Jamal Crawford,SG,33,LAC,20,0,546,115,256,.449,40,108,.370,75,148,.507,46,56,.821,10,39,49,53,12,2,41,29,316
94,Jordan Crawford,SG,25,BOS,20,16,581,92,208,.442,25,66,.379,67,142,.472,52,59,.881,11,53,64,104,22,2,42,39,261
95,Jae Crowder,SF,23,DAL,20,1,336,45,97,.464,22,55,.400,23,42,.548,6,10,.600,9,37,46,20,9,6,15,28,118
96,Dante Cunningham,SF,26,MIN,19,0,365,52,110,.473,0,2,.000,52,108,.481,0,2,.000,28,45,73,20,13,15,8,34,104
97,Jared Cunningham,SG,22,ATL,1,0,4,0,0,,0,0,,0,0,,0,0,,0,0,0,0,0,0,0,0,0
98,Stephen Curry,PG,25,GSW,16,16,577,130,280,.464,54,122,.443,76,158,.481,47,54,.870,10,58,68,140,30,4,60,38,361
99,Samuel Dalembert,C,32,DAL,20,17,464,59,98,.602,0,0,,59,98,.602,33,42,.786,48,90,138,9,14,29,24,56,151
100,Luigi Datome,SF,26,DET,11,0,72,13,33,.394,4,20,.200,9,13,.692,2,2,1.000,2,8,10,2,2,1,4,10,32
101,Brandon Davies,PF,22,PHI,16,0,185,12,37,.324,0,3,.000,12,34,.353,10,15,.667,12,21,33,12,8,3,9,24,34
102,Anthony Davis,C,20,NOP,16,16,537,112,225,.498,0,0,,112,225,.498,77,91,.846,60,103,163,25,26,58,22,49,301
103,Ed Davis,PF,24,MEM,15,2,233,37,70,.529,0,0,,37,70,.529,14,26,.538,23,41,64,10,2,14,8,27,88
104,Glen Davis,PF,28,ORL,7,5,218,43,86,.500,1,1,1.000,42,85,.494,11,17,.647,11,24,35,12,11,2,16,25,98
105,Austin Daye,SF,25,TOR,4,0,12,1,5,.200,0,4,.000,1,1,1.000,0,0,,1,3,4,1,0,0,0,4,2
106,Nando De Colo,SF,26,SAS,6,0,54,6,13,.462,4,10,.400,2,3,.667,0,1,.000,1,9,10,10,3,0,7,6,16
107,Dewayne Dedmon,C,24,GSW,4,0,6,0,1,.000,0,0,,0,1,.000,1,2,.500,0,0,0,0,0,0,0,1,1
108,Matthew Dellavedova,SG,23,CLE,11,3,151,14,31,.452,6,16,.375,8,15,.533,4,6,.667,2,14,16,10,7,0,5,14,38
109,Luol Deng,SF,28,CHI,17,17,656,120,262,.458,13,50,.260,107,212,.505,77,94,.819,27,93,120,71,18,4,45,43,330
110,DeMar DeRozan,SG,24,TOR,17,17,656,133,303,.439,25,64,.391,108,239,.452,80,101,.792,9,55,64,47,17,7,39,33,371
111,Boris Diaw,PF,31,SAS,17,5,390,77,135,.570,10,32,.313,67,103,.650,19,26,.731,12,47,59,29,8,9,24,25,183
112,Gorgui Dieng,C,24,MIN,11,0,64,6,13,.462,0,0,,6,13,.462,2,8,.250,7,14,21,7,3,12,8,14,14
113,Toney Douglas,PG,27,GSW,7,0,112,17,39,.436,11,25,.440,6,14,.429,0,0,,3,8,11,11,2,0,8,13,45
114,Goran Dragic,SG,27,PHO,16,15,553,101,208,.486,17,54,.315,84,154,.545,68,87,.782,10,37,47,107,16,6,43,39,287
115,Andre Drummond,C,20,DET,19,19,622,115,178,.646,0,0,,115,178,.646,27,73,.370,93,151,244,6,38,25,22,62,257
116,Jared Dudley,SF,28,LAC,20,20,554,63,139,.453,25,70,.357,38,69,.551,11,17,.647,8,21,29,29,11,2,22,55,162
117,Tim Duncan,C,37,SAS,16,16,446,84,189,.444,0,2,.000,84,187,.449,41,55,.745,26,103,129,46,6,30,28,21,209
118,Mike Dunleavy,SF,33,CHI,17,3,441,49,116,.422,25,56,.446,24,60,.400,20,23,.870,3,57,60,30,8,2,17,29,143
119,Kevin Durant,SF,25,OKC,17,17,665,145,319,.455,28,77,.364,117,242,.483,166,189,.878,16,123,139,86,24,14,62,37,484
120,Wayne Ellington,SG,26,DAL,12,0,101,12,31,.387,5,15,.333,7,16,.438,2,3,.667,2,7,9,4,3,2,2,10,31
121,Monta Ellis,PG,28,DAL,20,20,744,154,327,.471,17,47,.362,137,280,.489,106,126,.841,9,61,70,115,32,4,72,51,431
122,Jeremy Evans,SF,26,UTA,7,0,133,26,36,.722,0,0,,26,36,.722,6,10,.600,13,18,31,8,7,6,10,22,58
123,Reggie Evans,PF,33,BRK,15,4,209,8,26,.308,0,0,,8,26,.308,15,24,.625,22,54,76,1,3,2,15,29,31
124,Tyreke Evans,SF,24,NOP,18,0,461,82,200,.410,2,18,.111,80,182,.440,47,64,.734,15,66,81,68,23,7,35,45,213
125,Kenneth Faried,PF,24,DEN,18,16,450,80,147,.544,0,1,.000,80,146,.548,34,55,.618,61,98,159,18,12,12,19,31,194
126,Jordan Farmar,PG,27,LAL,18,0,341,63,144,.438,22,56,.393,41,88,.466,17,22,.773,13,40,53,80,12,4,37,27,165
127,Vitor Faverani,C,25,BOS,20,8,324,42,100,.420,9,27,.333,33,73,.452,20,33,.606,32,62,94,10,9,22,27,49,113
128,Derrick Favors,PF,22,UTA,20,20,654,106,207,.512,0,1,.000,106,206,.515,61,94,.649,62,135,197,28,26,24,44,72,273
129,Carrick Felix,SG,23,CLE,3,0,15,1,4,.250,0,1,.000,1,3,.333,2,2,1.000,1,1,2,1,0,0,2,1,4
130,Raymond Felton,PG,29,NYK,13,13,453,58,146,.397,15,53,.283,43,93,.462,14,18,.778,10,23,33,73,15,9,31,35,145
131,Landry Fields,SF,25,TOR,14,0,191,17,41,.415,0,2,.000,17,39,.436,11,19,.579,11,28,39,14,3,1,5,22,45
132,Derek Fisher,SG,39,OKC,16,0,209,17,46,.370,2,18,.111,15,28,.536,10,10,1.000,3,19,22,16,10,0,6,25,46
133,Evan Fournier,SG,21,DEN,18,0,207,28,73,.384,10,28,.357,18,45,.400,10,17,.588,6,20,26,13,1,3,9,31,76
134,Randy Foye,SG,30,DEN,18,18,459,61,152,.401,35,93,.376,26,59,.441,26,33,.788,2,38,40,39,15,10,22,47,183
135,Jamaal Franklin,SG,22,MEM,6,0,39,4,7,.571,0,1,.000,4,6,.667,0,0,,2,8,10,2,0,1,1,6,8
136,Jimmer Fredette,SG,24,SAC,6,0,73,9,25,.360,4,8,.500,5,17,.294,2,2,1.000,1,9,10,10,4,0,3,2,24
137,Joel Freeland,C,26,POR,18,0,261,25,59,.424,0,2,.000,25,57,.439,12,14,.857,33,29,62,19,5,11,15,34,62
138,Channing Frye,PF,30,PHO,19,19,516,79,168,.470,35,88,.398,44,80,.550,13,16,.813,17,84,101,18,18,16,16,62,206
139,Francisco Garcia,SF,32,HOU,19,2,407,55,129,.426,33,88,.375,22,41,.537,7,10,.700,6,42,48,25,12,16,15,40,150
140,Kevin Garnett,C,37,BRK,17,17,383,52,140,.371,0,3,.000,52,137,.380,6,7,.857,24,103,127,30,15,14,20,47,110
141,Diante Garrett,PG,25,UTA,11,0,167,20,46,.435,5,13,.385,15,33,.455,0,0,,3,6,9,35,9,0,15,6,45
142,Marc Gasol,C,29,MEM,13,13,447,77,168,.458,0,1,.000,77,167,.461,54,61,.885,20,72,92,56,12,14,22,33,208
143,Pau Gasol,C,33,LAL,18,18,551,108,258,.419,3,9,.333,105,249,.422,38,53,.717,30,149,179,56,4,23,41,34,257
144,Rudy Gay,SF,27,TOR,17,17,606,124,320,.388,21,56,.375,103,264,.390,64,84,.762,28,95,123,37,26,22,58,44,333
145,Alonzo Gee,SF,26,CLE,18,9,361,27,59,.458,7,20,.350,20,39,.513,10,12,.833,8,38,46,12,15,4,17,35,71
146,Paul George,SF,23,IND,19,19,694,166,354,.469,50,127,.394,116,227,.511,85,101,.842,13,100,113,65,41,7,52,43,467
147,Taj Gibson,PF,28,CHI,17,0,439,85,171,.497,0,1,.000,85,170,.500,33,46,.717,44,67,111,10,6,20,23,42,203
148,Manu Ginobili,SG,36,SAS,18,0,422,72,162,.444,24,70,.343,48,92,.522,18,20,.900,7,58,65,81,19,3,33,38,186
149,Rudy Gobert,C,21,UTA,14,0,161,11,24,.458,0,0,,11,24,.458,11,29,.379,23,41,64,2,4,11,17,27,33
150,Ryan Gomes,SF,31,OKC,3,0,23,2,6,.333,0,2,.000,2,4,.500,0,0,,0,2,2,1,0,0,1,5,4
151,Archie Goodwin,SG,19,PHO,18,0,199,28,69,.406,2,20,.100,26,49,.531,7,13,.538,5,25,30,7,7,6,19,12,65
152,Ben Gordon,SG,30,CHA,4,0,46,5,19,.263,0,4,.000,5,15,.333,7,10,.700,0,4,4,4,2,0,4,3,17
153,Eric Gordon,SG,25,NOP,18,18,579,101,244,.414,28,76,.368,73,168,.435,57,72,.792,11,41,52,54,33,4,37,28,287
154,Marcin Gortat,C,29,WAS,18,17,614,102,184,.554,1,1,1.000,101,183,.552,35,51,.686,38,127,165,28,9,29,30,40,240
155,Aaron Gray,C,29,TOR,4,0,20,2,3,.667,0,0,,2,3,.667,1,2,.500,3,5,8,3,0,0,4,7,5
156,Danny Green,SG,26,SAS,18,18,425,52,121,.430,32,75,.427,20,46,.435,4,4,1.000,5,55,60,25,22,17,19,22,140
157,Draymond Green,SF,23,GSW,19,0,362,34,76,.447,15,40,.375,19,36,.528,13,24,.542,12,66,78,24,22,15,19,40,96
158,Gerald Green,SG,28,PHO,19,12,532,91,209,.435,46,126,.365,45,83,.542,29,36,.806,10,42,52,26,12,8,36,53,257
159,Jeff Green,SF,27,BOS,20,20,681,114,251,.454,28,73,.384,86,178,.483,79,102,.775,16,73,89,33,7,7,39,36,335
160,Willie Green,SG,32,LAC,8,3,106,10,33,.303,2,9,.222,8,24,.333,3,4,.750,2,5,7,2,2,1,2,11,25
161,Blake Griffin,PF,24,LAC,20,20,731,168,315,.533,3,6,.500,165,309,.534,81,124,.653,47,168,215,61,21,14,54,70,420
162,Jordan Hamilton,SF,23,DEN,16,7,277,52,120,.433,24,63,.381,28,57,.491,13,16,.813,10,49,59,14,13,5,17,16,141
163,Tyler Hansbrough,PF,28,TOR,17,2,362,31,71,.437,0,1,.000,31,70,.443,53,70,.757,47,62,109,7,7,6,16,46,115
164,Tim Hardaway,SG,21,NYK,16,0,250,44,99,.444,20,51,.392,24,48,.500,13,15,.867,5,11,16,12,4,2,8,19,121
165,James Harden,SG,24,HOU,16,16,619,113,257,.440,31,106,.292,82,151,.543,124,144,.861,15,57,72,88,25,10,65,45,381
166,Maurice Harkless,SF,20,ORL,18,13,446,55,122,.451,14,36,.389,41,86,.477,22,44,.500,20,44,64,16,21,12,23,41,146
167,Josh Harrellson,C,24,DET,10,0,76,11,23,.478,3,9,.333,8,14,.571,0,0,,7,7,14,2,2,2,2,10,25
168,Al Harrington,PF,33,WAS,7,0,130,19,52,.365,12,28,.429,7,24,.292,5,7,.714,0,10,10,7,4,0,9,16,55
169,Elias Harris,SF,24,LAL,2,0,11,0,1,.000,0,0,,0,1,.000,0,0,,1,0,1,1,1,0,0,0,0
170,Mike Harris,PF,30,UTA,14,0,170,16,40,.400,0,2,.000,16,38,.421,22,23,.957,10,14,24,4,12,5,9,25,54
171,Tobias Harris,PF,21,ORL,1,0,16,3,8,.375,0,3,.000,3,5,.600,0,0,,0,1,1,0,0,0,1,2,6
172,Udonis Haslem,PF,33,MIA,10,6,144,13,29,.448,0,0,,13,29,.448,7,12,.583,7,16,23,2,2,2,6,23,33
173,Spencer Hawes,C,25,PHI,17,17,566,107,210,.510,32,71,.451,75,139,.540,29,40,.725,32,137,169,51,9,29,37,49,275
174,Chuck Hayes,C,30,SAC,14,1,145,10,23,.435,0,0,,10,23,.435,2,4,.500,16,19,35,4,10,1,6,15,22
175,Gordon Hayward,SF,23,UTA,20,20,737,117,298,.393,22,76,.289,95,222,.428,78,95,.821,20,88,108,101,27,9,64,45,334
176,Gerald Henderson,SG,26,CHA,19,19,612,100,250,.400,7,23,.304,93,227,.410,70,88,.795,14,77,91,48,19,5,37,44,277
177,Xavier Henry,SF,22,LAL,18,2,348,54,123,.439,14,31,.452,40,92,.435,43,74,.581,12,35,47,13,15,2,22,32,165
178,John Henson,PF,23,MIL,18,5,454,81,162,.500,0,0,,81,162,.500,26,42,.619,33,83,116,28,12,39,22,46,188
179,Roy Hibbert,C,27,IND,19,19,586,88,188,.468,1,3,.333,87,185,.470,60,79,.759,66,107,173,24,6,64,45,62,237
180,J.J. Hickson,PF,25,DEN,18,15,447,77,162,.475,0,1,.000,77,161,.478,29,54,.537,48,100,148,15,10,15,28,44,183
181,Nene Hilario,PF,31,WAS,15,15,497,85,167,.509,0,1,.000,85,166,.512,56,84,.667,19,78,97,44,15,16,28,50,226
182,George Hill,PG,27,IND,16,16,528,64,161,.398,24,64,.375,40,97,.412,42,51,.824,9,47,56,68,17,9,29,32,194
183,Jordan Hill,PF,26,LAL,18,10,396,68,126,.540,0,0,,68,126,.540,25,38,.658,58,95,153,20,7,18,22,46,161
184,Solomon Hill,SF,22,IND,14,0,135,7,21,.333,4,16,.250,3,5,.600,3,3,1.000,8,17,25,8,2,2,7,11,21
185,Kirk Hinrich,PG,33,CHI,17,7,524,49,129,.380,17,54,.315,32,75,.427,37,44,.841,6,48,54,88,15,6,36,55,152
186,Jrue Holiday,PG,23,NOP,18,18,620,112,253,.443,18,42,.429,94,211,.445,30,34,.882,18,60,78,145,27,8,60,53,272
187,Ryan Hollins,PF,29,LAC,17,0,167,20,29,.690,0,0,,20,29,.690,10,20,.500,9,22,31,1,1,8,14,34,50
188,Al Horford,C,27,ATL,20,20,656,152,278,.547,1,6,.167,151,272,.555,40,62,.645,38,122,160,48,21,33,45,36,345
189,Dwight Howard,C,28,HOU,20,20,665,114,205,.556,0,1,.000,114,204,.559,103,188,.548,69,182,251,35,12,35,63,74,331
190,Robbie Hummel,SF,24,MIN,14,1,165,14,43,.326,7,28,.250,7,15,.467,3,3,1.000,9,29,38,6,6,1,3,21,38
191,Kris Humphries,PF,28,BOS,15,0,202,27,56,.482,0,1,.000,27,55,.491,14,17,.824,14,47,61,6,1,13,10,18,68
192,Serge Ibaka,PF,24,OKC,17,17,580,107,210,.510,3,11,.273,104,199,.523,33,41,.805,51,121,172,16,4,44,24,43,250
193,Andre Iguodala,SF,30,GSW,13,13,483,60,110,.545,23,48,.479,37,62,.597,25,41,.610,7,48,55,82,25,4,32,27,168
194,Ersan Ilyasova,PF,26,MIL,11,7,275,45,96,.469,7,22,.318,38,74,.514,6,8,.750,17,37,54,20,13,3,21,28,103
195,Kyrie Irving,PG,21,CLE,18,18,629,139,344,.404,27,87,.310,112,257,.436,69,86,.802,14,46,60,105,18,4,58,44,374
196,Jarrett Jack,PG,30,CLE,18,0,482,67,157,.427,16,43,.372,51,114,.447,19,22,.864,4,37,41,67,15,9,41,24,169
197,Reggie Jackson,PG,23,OKC,17,3,413,77,160,.481,11,36,.306,66,124,.532,26,28,.929,6,59,65,60,15,2,36,20,191
198,Bernard James,C,28,DAL,8,0,45,4,6,.667,0,0,,4,6,.667,2,2,1.000,4,9,13,1,0,1,5,9,10
199,LeBron James,PF,29,MIA,19,19,673,173,296,.584,28,61,.459,145,235,.617,115,145,.793,12,97,109,115,23,8,67,24,489
200,Mike James,PG,38,CHI,6,0,35,1,9,.111,0,2,.000,1,7,.143,0,0,,0,3,3,6,1,0,1,8,2
201,Antawn Jamison,PF,37,LAC,6,0,90,12,32,.375,5,9,.556,7,23,.304,7,10,.700,2,17,19,2,3,0,4,13,36
202,Al Jefferson,PF,29,CHA,10,10,309,67,139,.482,0,0,,67,139,.482,27,40,.675,27,61,88,20,9,16,13,28,161
203,Richard Jefferson,SF,33,UTA,20,20,571,68,172,.395,25,73,.342,43,99,.434,33,42,.786,7,47,54,37,13,5,35,44,194
204,John Jenkins,SG,22,ATL,10,0,135,13,34,.382,4,17,.235,9,17,.529,3,3,1.000,1,16,17,9,1,1,9,7,33
205,Brandon Jennings,PG,24,DET,17,16,619,97,254,.382,27,79,.342,70,175,.400,50,65,.769,18,37,55,142,27,2,59,32,271
206,Jonas Jerebko,PF,26,DET,13,0,96,14,30,.467,3,10,.300,11,20,.550,10,13,.769,7,14,21,7,2,2,9,10,41
207,Amir Johnson,PF,26,TOR,17,15,477,66,119,.555,5,21,.238,61,98,.622,18,25,.720,39,66,105,21,9,14,26,63,155
208,Joe Johnson,SG,32,BRK,19,19,636,106,248,.427,36,87,.414,70,161,.435,53,64,.828,14,43,57,50,7,5,20,33,301
209,Orlando Johnson,SG,24,IND,19,0,251,28,67,.418,8,29,.276,20,38,.526,14,16,.875,5,33,38,14,4,1,11,14,78
210,Wesley Johnson,SF,26,LAL,18,10,443,58,133,.436,26,59,.441,32,74,.432,10,13,.769,15,52,67,24,18,28,18,56,152
211,James Jones,SF,33,MIA,5,3,52,8,19,.421,8,15,.533,0,4,.000,3,5,.600,0,3,3,4,1,1,1,0,27
212,Perry Jones,PF,22,OKC,12,0,110,16,28,.571,6,10,.600,10,18,.556,2,4,.500,4,17,21,4,2,5,5,8,40
213,Solomon Jones,PF,29,ORL,9,0,76,6,16,.375,0,0,,6,16,.375,2,4,.500,8,8,16,2,2,2,2,11,14
214,Terrence Jones,PF,22,HOU,17,12,389,64,126,.508,10,24,.417,54,102,.529,24,35,.686,32,76,108,17,4,21,19,31,162
215,DeAndre Jordan,C,25,LAC,20,20,705,79,130,.608,0,0,,79,130,.608,38,98,.388,88,170,258,19,23,43,31,71,196
216,Cory Joseph,SG,22,SAS,11,1,81,10,23,.435,1,2,.500,9,21,.429,19,23,.826,2,8,10,12,1,0,7,7,40
217,Chris Kaman,C,31,LAL,12,3,207,47,96,.490,0,0,,47,96,.490,5,6,.833,18,46,64,13,4,9,23,28,99
218,Enes Kanter,C,21,UTA,19,15,563,103,210,.490,0,0,,103,210,.490,38,50,.760,52,73,125,16,2,11,38,59,244
219,Sergey Karasev,SF,20,CLE,10,1,103,8,25,.320,4,14,.286,4,11,.364,9,10,.900,0,12,12,4,2,1,7,13,29
220,Ryan Kelly,PF,22,LAL,2,0,7,2,3,.667,2,3,.667,0,0,,0,1,.000,1,1,2,0,0,0,0,1,6
221,Michael Kidd-Gilchrist,SF,20,CHA,18,18,481,62,124,.500,0,5,.000,62,119,.521,40,60,.667,29,66,95,13,10,13,31,50,164
222,Andrei Kirilenko,PF,32,BRK,4,0,53,6,14,.429,0,0,,6,14,.429,11,19,.579,7,6,13,4,3,0,3,8,23
223,Brandon Knight,PG,22,MIL,10,7,229,31,87,.356,10,29,.345,21,58,.362,22,28,.786,2,21,23,42,6,1,27,14,94
224,Kyle Korver,SG,32,ATL,16,16,536,70,132,.530,44,85,.518,26,47,.553,15,16,.938,4,62,66,44,18,8,28,37,199
225,Kosta Koufos,C,24,MEM,18,5,394,58,123,.472,0,0,,58,123,.472,18,28,.643,37,81,118,16,11,21,20,45,134
226,Viacheslav Kravtsov,C,26,PHO,8,0,23,2,3,.667,0,0,,2,3,.667,2,4,.500,3,2,5,0,0,0,3,4,6
227,Ognjen Kuzmic,C,23,GSW,10,0,41,2,7,.286,0,0,,2,7,.286,1,3,.333,2,3,5,0,0,4,8,11,5
228,Doron Lamb,SG,22,ORL,7,0,63,3,12,.250,2,9,.222,1,3,.333,1,1,1.000,0,2,2,7,0,0,3,3,9
229,Jeremy Lamb,SG,21,OKC,17,0,347,64,138,.464,22,55,.400,42,83,.506,12,12,1.000,3,34,37,19,10,6,9,33,162
230,Shane Larkin,PG,21,DAL,9,0,110,10,36,.278,2,10,.200,8,26,.308,4,7,.571,2,7,9,15,11,0,11,10,26
231,Ty Lawson,PG,26,DEN,18,18,632,114,257,.444,22,62,.355,92,195,.472,97,130,.746,15,52,67,148,22,3,51,27,347
232,Ricky Ledo,SG,21,DAL,6,0,16,2,10,.200,1,4,.250,1,6,.167,2,2,1.000,0,2,2,1,0,0,2,1,7
233,Courtney Lee,SG,28,BOS,17,0,286,56,107,.523,13,27,.481,43,80,.538,7,8,.875,4,24,28,14,12,4,13,22,132
234,David Lee,PF,30,GSW,19,19,632,122,249,.490,0,1,.000,122,248,.492,79,97,.814,41,133,174,47,9,5,48,52,323
235,Alex Len,C,20,PHO,4,0,31,3,7,.429,0,0,,3,7,.429,1,2,.500,5,2,7,1,2,2,3,8,7
236,Kawhi Leonard,SF,22,SAS,18,17,492,88,178,.494,10,44,.227,78,134,.582,15,20,.750,22,90,112,24,37,9,21,35,201
237,Meyers Leonard,C,21,POR,3,0,21,3,4,.750,0,0,,3,4,.750,4,4,1.000,1,4,5,1,0,0,0,5,10
238,Jon Leuer,PF,24,MEM,9,0,123,21,46,.457,3,5,.600,18,41,.439,4,4,1.000,6,22,28,5,1,4,5,13,49
239,Rashard Lewis,SF,34,MIA,18,1,318,25,62,.403,12,37,.324,13,25,.520,9,13,.692,8,37,45,24,20,2,10,31,71
240,Damian Lillard,PG,23,POR,19,19,696,120,307,.391,52,131,.397,68,176,.386,92,102,.902,7,68,75,109,14,6,43,48,384
241,Jeremy Lin,PG,25,HOU,16,8,482,78,155,.503,23,59,.390,55,96,.573,66,82,.805,3,39,42,72,20,8,47,36,245
242,Shaun Livingston,PG,28,BRK,19,7,453,48,110,.436,0,1,.000,48,109,.440,38,46,.826,16,32,48,63,16,8,23,37,134
243,Brook Lopez,C,25,BRK,12,12,352,86,160,.538,0,1,.000,86,159,.541,64,79,.810,31,42,73,6,7,26,18,31,236
244,Robin Lopez,C,25,POR,19,19,574,65,135,.481,0,0,,65,135,.481,35,45,.778,76,83,159,15,8,28,22,52,165
245,Kevin Love,PF,25,MIN,19,19,681,147,335,.439,40,116,.345,107,219,.489,116,143,.811,73,186,259,77,16,6,50,40,450
246,Kyle Lowry,PG,27,TOR,17,17,620,76,188,.404,37,101,.366,39,87,.448,48,61,.787,14,48,62,112,31,3,39,60,237
247,John Lucas,PG,31,UTA,17,6,358,36,105,.343,15,49,.306,21,56,.375,5,7,.714,7,16,23,28,5,0,13,20,92
248,Shelvin Mack,PG,24,ATL,14,0,227,34,76,.447,8,21,.381,26,55,.473,9,12,.750,2,16,18,41,11,0,9,22,85
249,Ian Mahinmi,C,27,IND,18,0,278,14,36,.389,0,0,,14,36,.389,22,33,.667,20,35,55,3,9,15,17,47,50
250,Shawn Marion,SF,35,DAL,20,20,654,94,209,.450,18,51,.353,76,158,.481,25,32,.781,36,110,146,38,27,17,28,38,231
251,Cartier Martin,SF,29,ATL,20,2,401,47,124,.379,30,78,.385,17,46,.370,23,28,.821,3,39,42,17,13,4,18,36,147
252,Kenyon Martin,PF,36,NYK,16,8,293,27,51,.529,0,1,.000,27,50,.540,4,9,.444,18,46,64,30,13,11,8,35,58
253,Kevin Martin,SG,30,MIN,18,18,634,132,313,.422,45,102,.441,87,211,.412,108,115,.939,11,57,68,42,20,1,30,32,417
254,Roger Mason,SG,33,MIA,7,1,89,8,24,.333,6,16,.375,2,8,.250,3,3,1.000,1,7,8,6,3,1,4,9,25
255,Wesley Matthews,SG,27,POR,19,19,651,110,206,.534,52,104,.500,58,102,.569,40,51,.784,15,69,84,34,20,3,26,38,312
256,Jason Maxiell,PF,30,ORL,14,11,271,33,66,.500,0,0,,33,66,.500,7,13,.538,14,28,42,4,3,9,7,27,73
257,Eric Maynor,PG,26,WAS,17,0,186,20,61,.328,8,19,.421,12,42,.286,1,2,.500,7,16,23,35,5,1,16,10,49
258,O.J. Mayo,SG,26,MIL,18,17,557,97,236,.411,34,82,.415,63,154,.409,39,42,.929,12,49,61,48,13,2,47,44,267
259,Luc Mbah a Moute,SF-PF,27,TOT,11,5,240,18,40,.450,1,3,.333,17,37,.459,9,16,.563,14,22,36,16,10,7,7,20,46
259,Luc Mbah a Moute,SF,27,SAC,9,5,196,15,32,.469,1,3,.333,14,29,.483,9,13,.692,9,18,27,15,9,5,4,18,40
259,Luc Mbah a Moute,PF,27,MIN,2,0,44,3,8,.375,0,0,,3,8,.375,0,3,.000,5,4,9,1,1,2,3,2,6
260,JaVale McGee,C,26,DEN,5,5,79,17,38,.447,0,0,,17,38,.447,1,1,1.000,10,7,17,2,1,7,8,16,35
261,Ben McLemore,SG,20,SAC,16,10,366,50,136,.368,23,68,.338,27,68,.397,23,28,.821,11,33,44,16,12,3,16,33,146
262,Josh McRoberts,PF,26,CHA,18,18,506,56,139,.403,23,65,.354,33,74,.446,17,27,.630,25,71,96,73,17,8,20,49,152
263,Jodie Meeks,SG,26,LAL,18,12,506,81,165,.491,39,87,.448,42,78,.538,36,43,.837,6,40,46,15,15,1,18,26,237
264,Gal Mekel,PG,25,DAL,16,1,198,23,59,.390,3,14,.214,20,45,.444,8,10,.800,2,14,16,38,4,1,20,15,57
265,Khris Middleton,SF,22,MIL,18,11,451,72,150,.480,21,43,.488,51,107,.477,22,26,.846,7,58,65,28,17,5,25,49,187
266,C.J. Miles,SG,26,CLE,14,5,252,48,110,.436,21,56,.375,27,54,.500,9,10,.900,7,23,30,13,13,8,11,24,126
267,Andre Miller,SG,37,DEN,18,0,349,42,89,.472,8,10,.800,34,79,.430,17,23,.739,10,40,50,63,6,3,16,17,109
268,Darius Miller,SF,23,NOP,1,0,1,0,1,.000,0,1,.000,0,0,,0,0,,0,0,0,0,0,0,0,1,0
269,Mike Miller,SF,33,MEM,18,0,403,38,93,.409,26,59,.441,12,34,.353,9,11,.818,7,56,63,30,7,0,23,34,111
270,Quincy Miller,SF,21,DEN,3,0,8,2,5,.400,1,1,1.000,1,4,.250,0,2,.000,0,1,1,0,0,1,1,1,5
271,Patrick Mills,PG,25,SAS,18,0,293,48,102,.471,22,49,.449,26,53,.491,15,18,.833,4,18,22,25,19,1,13,19,133
272,Paul Millsap,PF,28,ATL,19,18,610,124,240,.517,14,34,.412,110,206,.534,45,74,.608,27,113,140,50,31,21,37,54,307
273,Tony Mitchell,PF,21,DET,7,0,21,2,3,.667,0,0,,2,3,.667,1,4,.250,4,3,7,1,0,1,0,2,5
274,Nazr Mohammed,C,36,CHI,17,0,151,10,27,.370,0,0,,10,27,.370,1,3,.333,22,23,45,6,5,7,9,17,21
275,Greg Monroe,PF,23,DET,19,19,645,111,215,.516,0,0,,111,215,.516,59,89,.663,61,109,170,43,23,13,43,50,281
276,E'Twaun Moore,SF,24,ORL,18,3,419,45,106,.425,16,41,.390,29,65,.446,16,17,.941,7,28,35,32,16,2,16,31,122
277,Darius Morris,PG,23,PHI,12,0,193,29,67,.433,10,24,.417,19,43,.442,15,21,.714,3,10,13,31,8,0,19,21,83
278,Marcus Morris,SF,24,PHO,19,0,433,70,154,.455,26,62,.419,44,92,.478,34,43,.791,25,70,95,19,19,4,28,36,200
279,Markieff Morris,PF,24,PHO,18,0,463,82,172,.477,6,16,.375,76,156,.487,50,61,.820,29,76,105,31,18,5,28,41,220
280,Anthony Morrow,SG,28,NOP,18,2,301,46,96,.479,21,45,.467,25,51,.490,10,13,.769,5,24,29,11,13,3,9,16,123
281,Donatas Motiejunas,PF,23,HOU,8,0,61,10,25,.400,2,8,.250,8,17,.471,4,7,.571,3,8,11,1,1,3,4,7,26
282,Timofey Mozgov,C,27,DEN,18,0,338,57,103,.553,0,3,.000,57,100,.570,41,57,.719,35,75,110,8,4,25,28,45,155
283,Shabazz Muhammad,SG,21,MIN,6,0,25,2,12,.167,1,3,.333,1,9,.111,1,2,.500,3,5,8,0,0,0,2,2,6
284,Byron Mullens,C,24,LAC,14,0,117,19,44,.432,8,28,.286,11,16,.688,1,4,.250,6,16,22,6,5,3,8,27,47
285,Erik Murphy,C,23,CHI,8,0,15,0,4,.000,0,0,,0,4,.000,0,0,,0,3,3,0,0,1,2,2,0
286,Toure' Murry,SF,24,NYK,5,0,17,3,8,.375,0,0,,3,8,.375,2,4,.500,1,1,2,1,2,0,1,1,8
287,Hamady N'Diaye,C,27,SAC,9,0,52,1,6,.167,0,0,,1,6,.167,0,1,.000,3,10,13,2,0,1,3,11,2
288,Steve Nash,PG,39,LAL,6,6,135,12,46,.261,5,13,.385,7,33,.212,11,12,.917,2,7,9,29,2,1,12,11,40
289,Gary Neal,SG,29,MIL,17,2,383,64,170,.376,29,66,.439,35,104,.337,28,33,.848,3,30,33,34,3,0,22,17,185
290,Nemanja Nedovic,SG,22,GSW,16,0,109,6,27,.222,1,12,.083,5,15,.333,5,6,.833,2,10,12,11,0,1,10,11,18
291,Jameer Nelson,PG,31,ORL,15,15,462,63,169,.373,29,90,.322,34,79,.430,20,23,.870,7,45,52,92,9,1,43,29,175
292,Andrew Nicholson,PF,24,ORL,18,0,370,69,134,.515,11,30,.367,58,104,.558,24,29,.828,20,74,94,3,6,7,18,43,173
293,Joakim Noah,C,28,CHI,17,17,537,66,137,.482,0,0,,66,137,.482,36,56,.643,51,98,149,58,17,13,27,56,168
294,Steve Novak,PF,30,TOR,11,0,125,14,42,.333,12,33,.364,2,9,.222,4,4,1.000,3,9,12,6,2,0,0,9,44
295,Dirk Nowitzki,PF,35,DAL,20,20,649,148,304,.487,29,72,.403,119,232,.513,92,99,.929,8,110,118,49,22,12,33,46,417
296,Jermaine O'Neal,PF,35,GSW,14,1,267,34,70,.486,0,0,,34,70,.486,27,34,.794,18,47,65,5,7,13,20,31,95
297,Kyle O'Quinn,C,23,ORL,12,0,140,21,39,.538,0,0,,21,39,.538,8,10,.800,11,32,43,8,2,11,8,21,50
298,Victor Oladipo,PG,21,ORL,18,8,538,88,211,.417,15,54,.278,73,157,.465,59,76,.776,6,73,79,68,31,13,68,49,250
299,Kelly Olynyk,C,22,BOS,14,6,317,42,108,.389,4,22,.182,38,86,.442,17,17,1.000,29,47,76,23,7,4,29,48,105
300,Arinze Onuaku,PF,26,NOP,3,0,25,1,4,.250,0,0,,1,4,.250,1,2,.500,2,5,7,3,0,0,1,3,3
301,Daniel Orton,C,23,PHI,14,4,187,16,36,.444,0,0,,16,36,.444,15,21,.714,10,35,45,8,3,11,17,28,47
302,Travis Outlaw,SF,29,SAC,14,0,208,29,64,.453,9,22,.409,20,42,.476,17,18,.944,13,34,47,9,6,5,6,18,84
303,Zaza Pachulia,C,29,MIL,17,11,428,38,105,.362,0,1,.000,38,104,.365,42,45,.933,47,64,111,30,16,5,29,43,118
304,Jannero Pargo,PG,34,CHA,4,0,18,4,10,.400,1,4,.250,3,6,.500,1,3,.333,0,0,0,1,1,0,5,2,10
305,Tony Parker,PG,31,SAS,17,17,528,128,241,.531,6,19,.316,122,222,.550,46,66,.697,3,40,43,108,8,1,45,17,308
306,Chandler Parsons,SF,25,HOU,18,18,669,118,222,.532,30,77,.390,88,145,.607,44,59,.746,10,81,91,71,20,11,39,42,310
307,Patrick Patterson,PF,24,SAC,15,6,370,46,107,.430,8,35,.229,38,72,.528,9,16,.563,28,57,85,13,13,3,16,37,109
308,Chris Paul,PG,28,LAC,19,19,658,118,260,.454,21,68,.309,97,192,.505,98,109,.899,11,79,90,224,44,3,50,53,355
309,Nikola Pekovic,C,28,MIN,19,19,631,119,225,.529,0,0,,119,225,.529,57,79,.722,68,98,166,19,11,8,30,42,295
310,Kendrick Perkins,C,29,OKC,15,15,269,19,43,.442,0,1,.000,19,42,.452,7,13,.538,16,37,53,18,7,7,21,43,45
311,Paul Pierce,SF,36,BRK,15,15,436,57,155,.368,15,56,.268,42,99,.424,57,67,.851,4,70,74,42,12,2,37,33,186
312,Mason Plumlee,PF,23,BRK,16,0,282,39,56,.696,0,0,,39,56,.696,31,54,.574,21,30,51,7,8,9,11,37,109
313,Miles Plumlee,C,25,PHO,19,19,549,84,168,.500,0,0,,84,168,.500,19,44,.432,46,116,162,10,10,37,28,47,187
314,Quincy Pondexter,SG,25,MEM,14,1,257,30,76,.395,11,32,.344,19,44,.432,19,24,.792,9,16,25,19,5,1,15,17,90
315,Phil Pressey,PG,22,BOS,17,0,202,12,47,.255,3,19,.158,9,28,.321,8,15,.533,4,14,18,34,15,1,10,16,35
316,A.J. Price,SG,27,MIN,7,0,32,3,10,.300,1,5,.200,2,5,.400,0,0,,0,3,3,3,0,0,3,3,7
317,Ronnie Price,SG,30,ORL,12,0,140,9,27,.333,3,12,.250,6,15,.400,3,5,.600,6,17,23,22,10,2,8,14,24
318,Pablo Prigioni,PG,36,NYK,17,3,273,22,42,.524,15,32,.469,7,10,.700,0,0,,3,29,32,38,16,1,12,38,59
319,Tayshaun Prince,SF,33,MEM,18,18,498,53,128,.414,3,14,.214,50,114,.439,15,21,.714,4,50,54,29,7,5,13,15,124
320,Miroslav Raduljica,C,26,MIL,7,0,52,4,8,.500,0,0,,4,8,.500,4,6,.667,3,8,11,5,0,2,3,11,12
321,Anthony Randolph,PF,24,DEN,6,2,84,11,25,.440,2,7,.286,9,18,.500,7,9,.778,2,16,18,3,6,4,9,13,31
322,Zach Randolph,PF,32,MEM,16,16,521,101,211,.479,0,4,.000,101,207,.488,50,63,.794,39,109,148,29,9,2,44,43,252
323,J.J. Redick,SG,29,LAC,17,17,479,92,200,.460,33,92,.359,59,108,.546,51,55,.927,7,31,38,35,15,3,17,37,268
324,Glen Rice,SG,23,WAS,7,0,43,3,14,.214,2,7,.286,1,7,.143,3,4,.750,1,8,9,5,2,1,5,1,11
325,Luke Ridnour,PG,32,MIL,11,3,238,24,71,.338,4,15,.267,20,56,.357,5,9,.556,6,14,20,42,12,1,15,13,57
326,Austin Rivers,SG,21,NOP,11,0,102,12,28,.429,2,7,.286,10,21,.476,11,16,.688,5,4,9,13,2,1,7,12,37
327,Andre Roberson,PF,22,OKC,6,1,39,2,4,.500,0,1,.000,2,3,.667,1,2,.500,7,3,10,1,0,0,4,6,5
328,Brian Roberts,PG,28,NOP,16,0,228,30,75,.400,10,29,.345,20,46,.435,10,10,1.000,2,12,14,35,6,1,10,32,80
329,Nate Robinson,PG,29,DEN,18,0,337,67,162,.414,24,57,.421,43,105,.410,26,32,.813,6,28,34,47,14,1,17,36,184
330,Thomas Robinson,PF,22,POR,19,0,215,38,83,.458,0,0,,38,83,.458,17,30,.567,20,46,66,6,3,2,13,30,93
331,Derrick Rose,PG,25,CHI,10,10,311,58,164,.354,16,47,.340,42,117,.359,27,32,.844,9,23,32,43,5,1,34,15,159
332,Terrence Ross,SG,22,TOR,17,0,323,41,97,.423,17,49,.347,24,48,.500,11,14,.786,8,34,42,11,7,3,10,27,110
333,Ricky Rubio,PG,23,MIN,19,19,624,58,157,.369,13,36,.361,45,121,.372,37,43,.860,16,70,86,162,56,3,58,49,166
334,Brandon Rush,SG,28,UTA,3,0,33,1,3,.333,0,1,.000,1,2,.500,0,0,,1,1,2,3,0,0,4,4,2
335,Robert Sacre,C,24,LAL,6,0,62,8,17,.471,0,0,,8,17,.471,6,10,.600,5,10,15,6,2,7,3,3,22
336,John Salmons,SF,34,SAC,16,8,391,35,100,.350,13,35,.371,22,65,.338,7,7,1.000,6,33,39,39,10,7,11,25,90
337,Larry Sanders,C,25,MIL,3,3,52,4,16,.250,0,0,,4,16,.250,0,0,,3,8,11,2,0,6,3,9,8
338,Dennis Schroeder,PG,20,ATL,11,0,153,16,45,.356,1,9,.111,15,36,.417,8,12,.667,1,11,12,27,4,0,18,14,41
339,Luis Scola,PF,33,IND,19,0,350,69,135,.511,0,3,.000,69,132,.523,20,27,.741,17,69,86,14,8,5,30,40,158
340,Mike Scott,PF,25,ATL,19,0,264,51,115,.443,8,29,.276,43,86,.500,23,31,.742,15,44,59,10,5,1,15,31,133
341,Thabo Sefolosha,SG,29,OKC,16,16,427,38,95,.400,11,36,.306,27,59,.458,15,16,.938,17,54,71,24,22,4,21,27,102
342,Kevin Seraphin,C,24,WAS,14,0,113,22,50,.440,0,0,,22,50,.440,6,6,1.000,11,8,19,3,1,3,11,27,50
343,Ramon Sessions,PG,27,CHA,19,0,395,60,152,.395,5,22,.227,55,130,.423,77,103,.748,8,24,32,52,10,4,33,17,202
344,Tornike Shengelia,SF,22,BRK,8,0,103,8,20,.400,0,6,.000,8,14,.571,2,5,.400,3,8,11,8,2,0,8,12,18
345,Iman Shumpert,SG,23,NYK,17,17,498,47,111,.423,19,48,.396,28,63,.444,20,23,.870,15,62,77,36,26,3,19,55,133
346,Alexey Shved,SG,25,MIN,16,0,136,10,42,.238,3,20,.150,7,22,.318,12,16,.750,5,12,17,9,4,4,8,5,35
347,Henry Sims,C,23,CLE,6,0,35,4,9,.444,0,0,,4,9,.444,2,4,.500,5,12,17,1,0,2,3,9,10
348,Kyle Singler,SF,25,DET,19,1,435,51,114,.447,14,44,.318,37,70,.529,33,39,.846,19,43,62,11,6,6,10,45,149
349,Chris Singleton,SF,24,WAS,4,0,50,7,13,.538,2,5,.400,5,8,.625,2,4,.500,1,11,12,0,2,1,5,6,18
350,Peyton Siva,SG,23,DET,9,0,41,1,4,.250,0,2,.000,1,2,.500,0,0,,1,4,5,2,3,0,9,8,2
351,Donald Sloan,SG,26,IND,8,0,77,10,20,.500,3,9,.333,7,11,.636,5,7,.714,1,14,15,10,4,0,3,5,28
352,Greg Smith,C,23,HOU,4,0,17,6,7,.857,0,0,,6,7,.857,0,1,.000,6,3,9,0,0,0,2,1,12
353,Ishmael Smith,PG,25,PHO,13,0,156,15,48,.313,1,9,.111,14,39,.359,3,3,1.000,1,14,15,26,10,3,12,10,34
354,J.R. Smith,SF,28,NYK,12,3,374,50,148,.338,23,75,.307,27,73,.370,14,23,.609,14,43,57,23,13,2,19,33,137
355,Jason Smith,PF,27,NOP,18,18,508,83,169,.491,0,0,,83,169,.491,22,26,.846,36,67,103,14,8,20,13,60,188
356,Josh Smith,SF,28,DET,19,18,686,106,268,.396,24,89,.270,82,179,.458,36,67,.537,25,104,129,66,33,31,53,50,272
357,Tony Snell,SG,22,CHI,12,5,191,23,48,.479,11,26,.423,12,22,.545,6,9,.667,3,13,16,11,4,0,9,8,63
358,James Southerland,SF,23,CHA,1,0,3,0,3,.000,0,1,.000,0,2,.000,0,0,,0,0,0,0,0,0,0,0,0
359,Marreese Speights,C,26,GSW,19,0,215,27,85,.318,3,10,.300,24,75,.320,15,18,.833,21,42,63,10,2,6,15,32,72
360,Tiago Splitter,C,29,SAS,18,15,386,63,106,.594,0,0,,63,106,.594,32,44,.727,43,80,123,19,7,9,22,33,158
361,Lance Stephenson,SG,23,IND,19,19,664,93,198,.470,20,55,.364,73,143,.510,25,41,.610,27,98,125,95,15,3,53,51,231
362,Greg Stiemsma,C,28,NOP,8,0,123,7,14,.500,0,0,,7,14,.500,2,4,.500,11,26,37,3,1,8,9,18,16
363,Julyan Stone,SG,25,TOR,9,0,56,3,7,.429,2,5,.400,1,2,.500,2,3,.667,0,5,5,7,1,0,1,4,10
364,Amar'e Stoudemire,C,31,NYK,13,0,193,32,66,.485,0,0,,32,66,.485,6,15,.400,13,25,38,8,5,2,17,25,70
365,Rodney Stuckey,SG,27,DET,18,0,513,105,221,.475,10,29,.345,95,192,.495,71,85,.835,15,30,45,43,18,5,35,41,291
366,Jared Sullinger,PF,21,BOS,18,8,461,97,204,.475,14,45,.311,83,159,.522,30,40,.750,40,94,134,26,9,11,33,53,238
367,Jeff Taylor,SF,24,CHA,19,1,449,59,155,.381,12,47,.255,47,108,.435,21,39,.538,10,32,42,14,5,2,19,49,151
368,Tyshawn Taylor,PG,23,BRK,13,3,225,28,80,.350,3,11,.273,25,69,.362,22,28,.786,3,11,14,33,9,0,24,28,81
369,Jeff Teague,PG,25,ATL,20,20,658,110,269,.409,13,50,.260,97,219,.443,103,126,.817,11,42,53,159,26,3,67,45,336
370,Marquis Teague,SG,20,CHI,10,0,100,4,27,.148,0,3,.000,4,24,.167,3,6,.500,1,5,6,10,0,0,9,9,11
371,Mirza Teletovic,SF,28,BRK,13,0,200,24,68,.353,15,42,.357,9,26,.346,9,13,.692,11,38,49,7,4,2,11,20,72
372,Garrett Temple,SG,27,WAS,16,0,175,11,32,.344,0,8,.000,11,24,.458,3,4,.750,7,9,16,12,7,3,14,20,25
373,Jason Terry,PG,36,BRK,11,0,191,21,54,.389,12,34,.353,9,20,.450,4,5,.800,1,12,13,17,3,0,7,18,58
374,Hasheem Thabeet,C,26,OKC,2,0,19,2,4,.500,0,0,,2,4,.500,0,1,.000,1,5,6,0,0,0,1,5,4
375,Isaiah Thomas,PG,24,SAC,16,0,441,90,200,.450,24,60,.400,66,140,.471,77,90,.856,15,23,38,72,18,0,41,36,281
376,Lance Thomas,SF,25,NOP,5,0,42,2,9,.222,0,0,,2,9,.222,2,4,.500,2,5,7,3,0,0,2,4,6
377,Hollis Thompson,SF,22,PHI,17,2,284,32,66,.485,8,24,.333,24,42,.571,11,15,.733,17,34,51,13,5,3,9,19,83
378,Jason Thompson,PF,27,SAC,16,10,342,48,104,.462,0,0,,48,104,.462,12,19,.632,24,66,90,15,3,9,23,55,108
379,Klay Thompson,SG,23,GSW,19,19,718,146,304,.480,68,143,.476,78,161,.484,44,58,.759,15,50,65,45,19,9,35,57,404
380,Tristan Thompson,PF,22,CLE,18,18,589,72,171,.421,0,1,.000,72,170,.424,56,75,.747,67,116,183,11,11,11,29,37,200
381,Marcus Thornton,SG,26,SAC,12,6,321,45,118,.381,20,65,.308,25,53,.472,13,16,.813,9,23,32,15,12,1,6,19,123
382,Jamaal Tinsley,PG,35,UTA,8,5,110,4,20,.200,1,15,.067,3,5,.600,0,0,,2,9,11,23,2,0,9,10,9
383,Anthony Tolliver,PF,28,CHA,14,1,208,13,44,.295,12,35,.343,1,9,.111,4,4,1.000,6,24,30,10,3,3,7,21,42
384,P.J. Tucker,SF,28,PHO,19,19,592,67,143,.469,24,48,.500,43,95,.453,18,27,.667,34,55,89,32,27,4,27,47,176
385,Ronny Turiaf,PF,31,MIN,2,0,19,1,4,.250,0,0,,1,4,.250,1,1,1.000,1,2,3,2,1,1,0,4,3
386,Evan Turner,SF,25,PHI,19,19,704,154,329,.468,12,50,.240,142,279,.509,88,105,.838,21,109,130,74,21,0,73,54,408
387,Ekpe Udoh,PF,26,MIL,15,7,317,29,71,.408,0,0,,29,71,.408,18,28,.643,28,34,62,13,7,19,17,36,76
388,Beno Udrih,SG,31,NYK,11,4,166,19,49,.388,6,13,.462,13,36,.361,0,2,.000,6,15,21,26,2,0,14,18,44
389,Jonas Valanciunas,C,21,TOR,17,17,462,66,137,.482,0,0,,66,137,.482,24,31,.774,47,82,129,9,6,18,30,52,156
390,Anderson Varejao,C,31,CLE,18,9,530,67,129,.519,0,4,.000,67,125,.536,27,39,.692,48,96,144,37,24,13,18,46,161
391,Greivis Vasquez,PG,27,SAC,16,16,421,62,140,.443,15,47,.319,47,93,.505,28,30,.933,5,28,33,85,6,0,26,36,167
392,Jan Vesely,PF,23,WAS,12,1,216,13,31,.419,0,0,,13,31,.419,6,12,.500,27,29,56,2,13,7,11,26,32
393,Charlie Villanueva,PF,29,DET,5,0,38,10,22,.455,4,13,.308,6,9,.667,0,0,,1,5,6,0,1,2,1,2,24
394,Nikola Vucevic,C,23,ORL,17,17,565,106,195,.544,0,0,,106,195,.544,38,49,.776,52,133,185,43,19,18,46,47,250
395,Dwyane Wade,SG,32,MIA,14,14,472,102,192,.531,2,8,.250,100,184,.543,53,75,.707,11,54,65,76,30,9,51,33,259
396,Dion Waiters,SG,22,CLE,16,9,453,82,199,.412,21,52,.404,61,147,.415,41,61,.672,7,45,52,42,20,5,42,35,226
397,Kemba Walker,PG,23,CHA,19,19,662,115,302,.381,25,83,.301,90,219,.411,60,76,.789,13,68,81,79,28,9,47,28,315
398,John Wall,PG,23,WAS,18,18,670,121,291,.416,22,64,.344,99,227,.436,78,93,.839,9,71,80,166,41,5,60,31,342
399,Gerald Wallace,SF,31,BOS,20,4,494,37,74,.500,10,23,.435,27,51,.529,12,30,.400,11,59,70,54,30,4,44,34,96
400,C.J. Watson,PG,29,IND,18,3,374,39,99,.394,16,47,.340,23,52,.442,23,27,.852,6,23,29,37,12,2,15,20,117
401,Earl Watson,PG,34,POR,4,0,22,0,1,.000,0,1,.000,0,0,,0,0,,1,1,2,5,0,0,3,6,0
402,Martell Webster,SF,27,WAS,18,10,606,76,168,.452,45,110,.409,31,58,.534,27,32,.844,16,71,87,41,19,6,11,35,224
403,David West,PF,33,IND,19,19,574,98,222,.441,1,5,.200,97,217,.447,40,51,.784,24,115,139,58,19,21,25,40,237
404,Russell Westbrook,PG,25,OKC,14,14,467,102,259,.394,21,62,.339,81,197,.411,64,88,.727,17,48,65,78,25,1,53,33,289
405,Deron Williams,PG,29,BRK,9,9,217,32,79,.405,9,24,.375,23,55,.418,11,14,.786,0,16,16,54,5,2,24,17,84
406,Derrick Williams,PF-SF,22,TOT,14,3,242,31,80,.388,2,20,.100,29,60,.483,19,23,.826,3,36,39,5,6,4,10,15,83
406,Derrick Williams,PF,22,MIN,11,0,162,19,54,.352,2,15,.133,17,39,.436,14,16,.875,3,23,26,1,4,4,6,9,54
406,Derrick Williams,SF,22,SAC,3,3,80,12,26,.462,0,5,.000,12,21,.571,5,7,.714,0,13,13,4,2,0,4,6,29
407,Elliot Williams,SG,24,PHI,6,0,62,5,20,.250,2,10,.200,3,10,.300,5,6,.833,4,6,10,0,0,1,3,8,17
408,Louis Williams,PG,27,ATL,7,2,142,20,57,.351,7,23,.304,13,34,.382,8,9,.889,4,10,14,25,3,2,4,6,55
409,Marvin Williams,PF,27,UTA,13,5,338,52,111,.468,22,54,.407,30,57,.526,9,13,.692,17,50,67,14,11,5,12,35,135
410,Mo Williams,PG,31,POR,18,0,453,68,164,.415,17,44,.386,51,120,.425,12,13,.923,10,25,35,82,13,5,42,52,165
411,Shawne Williams,PF,27,LAL,16,5,303,29,83,.349,20,59,.339,9,24,.375,2,4,.500,14,51,65,17,9,15,11,54,80
412,Jeff Withey,C,23,NOP,8,0,48,5,7,.714,0,0,,5,7,.714,8,10,.800,5,6,11,2,2,2,3,5,18
413,Nate Wolters,PG,22,MIL,14,7,371,41,101,.406,2,21,.095,39,80,.488,20,27,.741,10,28,38,61,10,5,17,19,104
414,Metta World Peace,SF,34,NYK,15,0,251,36,98,.367,10,36,.278,26,62,.419,5,7,.714,9,25,34,10,13,7,10,28,87
415,Dorell Wright,SF,28,POR,19,0,274,30,78,.385,18,52,.346,12,26,.462,13,16,.813,9,45,54,14,4,3,8,16,91
416,Tony Wroten,SG,20,PHI,17,4,417,80,186,.430,11,53,.208,69,133,.519,36,64,.563,15,36,51,53,17,3,41,34,207
417,Nick Young,SG,28,LAL,18,6,450,89,202,.441,24,66,.364,65,136,.478,53,66,.803,9,27,36,21,18,4,16,42,255
418,Thaddeus Young,PF,25,PHI,16,15,531,109,228,.478,14,34,.412,95,194,.490,30,46,.652,42,73,115,24,23,9,29,40,262
419,Cody Zeller,C,21,CHA,19,0,351,34,102,.333,0,0,,34,102,.333,23,31,.742,30,48,78,18,11,8,25,45,91
420,Tyler Zeller,C,24,CLE,12,0,93,10,20,.500,0,0,,10,20,.500,7,8,.875,5,17,22,2,2,3,5,14,27
